시군구,읍면동명,adm_cd,선거인수,투표수,박영선,오세훈,신지혜,허경영,오태양,이수봉,배영규,김진아,송명숙,정동희,이도엽,신지예,계,무효투표수,기권수
종로구,청운효자동,1101072,9657,5936,2694,2983,34,63,10,15,0,37,19,0,1,46,5902,34,3721
종로구,사직동,1101053,8233,4922,1744,3004,28,34,15,5,0,24,8,2,1,36,4901,21,3311
종로구,삼청동,1101054,2152,1282,483,750,8,19,2,1,0,8,2,0,0,4,1277,5,870
종로구,부암동,1101055,8025,4814,2031,2615,25,47,6,6,1,14,11,1,2,26,4785,29,3211
종로구,평창동,1101056,15026,9275,3048,5916,42,86,15,15,1,48,15,5,1,44,9236,39,5751
종로구,무악동,1101057,6552,4298,1684,2451,22,28,4,14,0,36,8,4,0,23,4274,24,2254
종로구,교남동,1101058,8385,5401,2009,3170,25,51,10,12,0,37,9,1,5,28,5357,44,2984
종로구,가회동,1101060,3831,2425,1084,1241,12,20,10,6,0,17,8,1,1,14,2414,11,1406
종로구,종로1·2·3·4가동,1101061,6698,3227,1296,1817,14,39,10,3,2,13,3,1,3,9,3210,17,3471
종로구,종로5·6가동,1101063,4753,2401,948,1365,8,28,3,5,0,15,6,1,0,11,2390,11,2352
종로구,이화동,1101064,6748,3879,1727,1943,29,51,12,15,1,27,15,2,0,18,3840,39,2869
종로구,혜화동,1101073,14506,8432,3364,4583,98,90,26,22,0,78,20,4,3,60,8348,84,6074
종로구,창신1동,1101067,4887,2678,1259,1325,17,29,4,7,0,10,3,0,1,4,2659,19,2209
종로구,창신2동,1101068,7384,3701,1815,1774,10,31,2,7,1,11,8,0,1,9,3669,32,3683
종로구,창신3동,1101069,5679,3356,1500,1740,15,33,3,10,0,19,4,1,2,10,3337,19,2323
종로구,숭인1동,1101070,5222,2776,1238,1443,13,26,6,7,1,11,2,1,0,14,2762,14,2446
종로구,숭인2동,1101071,8647,4218,1932,2097,22,49,10,7,2,43,12,3,1,9,4187,31,4429
중구,소공동,1102052,1814,1023,363,612,6,12,1,3,0,10,2,0,0,6,1015,8,791
중구,회현동,1102054,4658,2287,756,1465,10,22,2,4,2,4,4,1,0,7,2277,10,2371
중구,명동,1102055,2586,1297,485,774,2,11,4,3,0,5,1,0,0,5,1290,7,1289
중구,필동,1102057,3989,2385,967,1301,11,32,6,6,0,15,5,1,1,12,2357,28,1604
중구,장충동,1102058,4238,2291,932,1236,18,26,4,8,0,18,13,0,0,5,2260,31,1947
중구,광희동,1102059,4522,2102,695,1324,10,18,5,2,0,18,4,3,2,6,2087,15,2420
중구,을지로동,1102060,1753,907,338,537,2,8,2,1,1,7,1,0,1,3,901,6,846
중구,신당동,1102069,7328,3810,1576,2087,19,32,4,9,0,23,17,2,1,10,3780,30,3518
중구,다산동,1102070,11918,6232,2580,3344,36,77,17,12,0,47,13,4,5,35,6170,62,5686
중구,약수동,1102071,14813,9008,3398,5361,35,65,9,16,0,38,6,4,3,27,8962,46,5805
중구,청구동,1102072,11791,7198,2771,4154,36,67,9,22,1,41,10,2,4,31,7148,50,4593
중구,신당5동,1102065,9304,4903,2136,2587,26,45,9,6,0,28,9,1,4,16,4867,36,4401
중구,동화동,1102073,8937,5359,2068,3091,16,48,3,10,2,50,20,2,2,15,5327,32,3578
중구,황학동,1102067,11159,5560,2339,3001,16,84,6,13,0,39,14,0,5,13,5530,30,5599
중구,중림동,1102068,10060,6077,2417,3463,18,58,8,10,0,38,8,1,1,23,6045,32,3983
용산구,후암동,1103051,14918,8202,3592,4271,34,100,16,23,0,47,20,3,3,38,8147,55,6716
용산구,용산2가동,1103052,8868,4544,1919,2384,33,47,17,13,0,34,15,1,2,41,4506,38,4324
용산구,남영동,1103053,7392,3763,1608,1997,22,53,8,9,0,17,8,3,2,10,3737,26,3629
용산구,청파동,1103071,16721,8099,3392,4145,68,102,16,26,1,193,29,4,3,59,8038,61,8622
용산구,원효로1동,1103072,13660,7911,2748,4851,40,57,10,14,2,76,15,2,1,28,7844,67,5749
용산구,원효로2동,1103057,11519,6772,2542,3983,31,58,12,16,2,54,11,2,3,24,6738,34,4747
용산구,효창동,1103058,8640,5266,2033,2991,34,46,9,9,0,52,12,1,2,32,5221,45,3374
용산구,용문동,1103059,10573,6287,2505,3548,42,43,7,16,0,39,18,3,1,17,6239,48,4286
용산구,한강로동,1103073,18136,10509,2695,7462,30,82,16,21,0,73,16,2,3,40,10440,69,7627
용산구,이촌1동,1103063,22304,14681,2863,11543,26,66,22,15,0,54,11,3,4,37,14644,37,7623
용산구,이촌2동,1103064,7245,4636,1452,3065,13,45,5,10,0,11,5,2,0,8,4616,20,2609
용산구,이태원1동,1103065,6456,3322,990,2220,12,29,13,5,0,14,4,1,0,13,3301,21,3134
용산구,이태원2동,1103066,8151,4172,1461,2537,19,43,16,4,1,37,9,1,1,29,4158,14,3979
용산구,한남동,1103074,17689,8780,2475,6035,22,80,20,9,1,44,16,2,0,32,8736,44,8909
용산구,서빙고동,1103069,10220,6145,1374,4602,18,46,8,9,1,29,6,1,2,17,6113,32,4075
용산구,보광동,1103070,12968,6422,2361,3807,26,57,17,13,0,37,16,2,1,40,6377,45,6546
성동구,금호1가동,1104059,12731,7253,2699,4322,29,65,5,6,1,34,18,2,1,19,7201,52,5478
성동구,금호2·3가동,1104072,19325,10766,4140,6300,39,98,10,21,1,59,10,6,2,24,10710,56,8559
성동구,금호4가동,1104062,12370,7445,2711,4541,28,51,10,18,0,27,7,5,2,14,7414,31,4925
성동구,옥수동,1104073,21749,13170,3815,9033,39,97,16,21,0,41,15,7,2,32,13118,52,8579
성동구,응봉동,1104058,13000,7868,2926,4687,32,69,8,26,0,38,13,3,1,25,7828,40,5132
성동구,성수1가1동,1104065,13897,7783,2509,4995,27,64,14,20,0,55,18,1,3,42,7748,35,6114
성동구,성수1가2동,1104066,11967,7275,2685,4302,29,69,8,25,1,54,15,1,4,25,7218,57,4692
성동구,성수2가1동,1104067,14765,7905,2778,4867,28,89,4,11,2,43,20,4,0,17,7863,42,6860
성동구,성수2가3동,1104068,9937,5632,1989,3433,23,53,6,11,1,38,14,5,1,14,5588,44,4305
성동구,왕십리도선동,1104071,22271,12703,4525,7703,42,127,16,23,3,90,20,3,4,53,12609,94,9568
성동구,왕십리2동,1104052,14401,8150,3494,4330,41,88,15,19,0,42,21,2,1,23,8076,74,6251
성동구,행당1동,1104056,12287,7470,2659,4505,38,85,9,27,2,49,18,3,3,26,7424,46,4817
성동구,행당2동,1104057,19295,11855,4469,6973,49,110,7,27,0,74,30,5,1,32,11777,78,7440
성동구,마장동,1104054,19423,10950,4368,6092,64,137,15,26,0,86,29,3,3,41,10864,86,8473
성동구,사근동,1104055,10356,4991,1789,2916,50,40,13,25,0,50,12,1,7,19,4922,69,5365
성동구,송정동,1104069,9283,4783,1980,2622,12,52,9,10,1,28,14,2,3,19,4752,31,4500
성동구,용답동,1104070,10715,5198,2362,2623,21,50,5,8,1,40,20,2,2,23,5157,41,5517
광진구,중곡1동,1105055,13765,7144,3202,3577,30,109,12,19,0,79,19,2,1,29,7079,65,6621
광진구,중곡2동,1105056,18767,9696,4251,4993,63,103,12,28,1,104,31,6,4,28,9624,72,9071
광진구,중곡3동,1105057,14483,7368,3174,3886,38,93,10,20,1,47,20,7,6,14,7316,52,7115
광진구,중곡4동,1105058,25433,14211,6183,7432,73,183,18,36,1,90,40,9,3,55,14123,88,11222
광진구,능동,1105059,10322,5774,2467,2949,37,81,13,17,0,80,17,2,3,32,5698,76,4548
광진구,구의1동,1105060,20159,10861,4636,5661,71,127,35,22,3,124,28,3,1,48,10759,102,9298
광진구,구의2동,1105061,22193,12493,5426,6603,61,130,18,28,1,78,23,3,2,45,12418,75,9700
광진구,구의3동,1105062,25136,16046,5367,10147,47,122,26,29,4,136,17,6,3,36,15940,106,9090
광진구,광장동,1105063,25020,15561,5128,10001,52,104,15,28,1,71,17,4,1,43,15465,96,9459
광진구,자양1동,1105064,20404,10982,4627,5878,52,124,41,24,3,80,35,3,3,39,10909,73,9422
광진구,자양2동,1105065,20783,11813,4518,6884,39,95,35,22,0,94,19,3,3,37,11749,64,8970
광진구,자양3동,1105066,23517,15190,5001,9769,44,98,28,20,1,82,21,4,4,37,15109,81,8327
광진구,자양4동,1105067,16430,8913,3320,5274,30,81,19,22,2,52,20,2,3,25,8850,63,7517
광진구,화양동,1105053,21582,9363,3439,5224,72,127,37,37,1,159,43,5,5,68,9217,146,12219
광진구,군자동,1105054,17430,8879,3705,4718,53,109,19,38,2,78,25,3,1,45,8796,83,8551
동대문구,용신동,1106081,27581,13682,5638,7464,65,132,18,39,2,117,36,3,2,51,13567,115,13899
동대문구,제기동,1106082,21806,11937,4510,6958,55,122,17,24,2,62,35,4,2,47,11838,99,9869
동대문구,전농1동,1106083,24765,13462,5297,7636,57,138,8,28,4,95,35,5,7,48,13358,104,11303
동대문구,전농2동,1106084,16550,10151,4098,5715,42,95,13,23,1,52,28,7,3,20,10097,54,6399
동대문구,답십리1동,1106091,23759,13676,5393,7799,54,117,22,34,3,90,38,1,4,38,13593,83,10083
동대문구,답십리2동,1106086,24010,13738,5721,7565,52,144,10,32,2,68,31,4,7,26,13662,76,10272
동대문구,장안1동,1106087,32970,17728,7521,9595,61,194,16,29,3,98,31,5,5,45,17603,125,15242
동대문구,장안2동,1106088,27353,15466,6573,8429,60,126,8,29,0,79,27,5,7,36,15379,87,11887
동대문구,청량리동,1106080,17094,9869,3552,5986,35,116,7,20,1,47,16,3,4,24,9811,58,7225
동대문구,회기동,1106071,10102,5712,2076,3272,64,52,17,17,0,73,20,3,1,44,5639,73,4390
동대문구,휘경1동,1106072,11591,6263,2386,3563,40,56,7,16,1,65,36,0,1,30,6201,62,5328
동대문구,휘경2동,1106073,19728,10732,4111,6123,66,104,14,40,0,91,32,2,3,42,10628,104,8996
동대문구,이문1동,1106089,15684,8537,3153,4930,52,93,20,19,3,79,36,3,2,59,8449,88,7147
동대문구,이문2동,1106090,16516,9724,4046,5261,47,107,14,23,2,70,34,4,6,38,9652,72,6792
중랑구,면목본동,1107071,30632,14448,6306,7485,68,198,19,34,3,89,64,7,8,52,14333,115,16184
중랑구,면목2동,1107052,21089,9964,4346,5252,31,104,9,26,0,66,34,3,3,22,9896,68,11125
중랑구,면목3·8동,1107072,21949,10869,4666,5811,38,132,10,21,1,49,20,4,5,23,10780,89,11080
중랑구,면목4동,1107054,16615,8786,3919,4548,26,94,14,24,1,55,14,7,2,24,8728,58,7829
중랑구,면목5동,1107055,12245,6732,3104,3400,30,69,10,16,0,35,14,1,1,20,6700,32,5513
중랑구,면목7동,1107057,19445,10275,4425,5470,44,109,12,21,1,64,24,4,2,30,10206,69,9170
중랑구,상봉1동,1107059,19301,10190,4246,5526,40,111,8,23,0,73,34,3,4,40,10108,82,9111
중랑구,상봉2동,1107060,18333,8615,3716,4482,39,103,10,18,1,99,30,6,3,30,8537,78,9718
중랑구,중화1동,1107061,17778,9659,4179,5053,37,161,15,24,2,61,28,4,1,37,9602,57,8119
중랑구,중화2동,1107062,21823,10069,4417,5172,52,157,15,29,0,72,26,4,3,36,9983,86,11754
중랑구,묵1동,1107064,28465,15865,6510,8696,81,187,14,34,5,128,34,3,4,55,15751,114,12600
중랑구,묵2동,1107065,17350,9199,3985,4853,38,120,11,19,1,51,26,3,3,23,9133,66,8151
중랑구,망우본동,1107073,27029,14088,5509,8087,47,162,12,30,4,77,43,8,6,24,14009,79,12941
중랑구,망우3동,1107068,15562,7724,3391,4019,33,113,4,12,0,49,16,5,1,21,7664,60,7838
중랑구,신내1동,1107069,30086,16955,7164,9186,57,178,14,34,4,103,47,8,4,45,16844,111,13131
중랑구,신내2동,1107070,20415,13376,5984,6876,64,143,12,28,1,103,26,11,1,50,13299,77,7039
성북구,성북동,1108081,14477,8436,3681,4371,57,71,24,17,2,66,21,2,2,69,8383,53,6041
성북구,삼선동,1108082,21460,12336,5584,6157,79,137,15,30,2,149,26,3,4,71,12257,79,9124
성북구,동선동,1108083,13613,7044,3021,3401,74,77,9,34,1,244,42,0,2,69,6974,70,6569
성북구,돈암1동,1108058,12945,8194,3368,4482,49,84,9,14,0,62,20,2,2,37,8129,65,4751
성북구,돈암2동,1108059,18975,11605,4662,6532,50,106,9,27,0,70,20,4,4,44,11528,77,7370
성북구,안암동,1108060,13480,7127,2636,4016,68,75,18,25,4,99,24,3,2,57,7027,100,6353
성북구,보문동,1108061,13070,6676,2873,3507,35,55,7,23,1,56,30,5,4,33,6629,47,6394
성북구,정릉1동,1108062,15042,9121,3924,4847,44,92,9,23,0,54,22,3,3,42,9063,58,5921
성북구,정릉2동,1108063,19230,10849,4695,5730,57,139,13,15,1,63,23,5,5,40,10786,63,8381
성북구,정릉3동,1108064,12397,6003,2410,3303,30,105,8,13,1,43,16,4,2,18,5953,50,6394
성북구,정릉4동,1108065,21227,12146,5363,6358,60,113,6,36,0,61,31,5,3,44,12080,66,9081
성북구,길음1동,1108066,26394,16608,7009,9085,87,108,10,40,1,97,20,4,5,65,16531,77,9786
성북구,길음2동,1108068,13343,7786,3084,4436,32,76,6,19,2,46,11,4,1,25,7742,44,5557
성북구,종암동,1108084,32368,18960,8096,10104,85,197,30,35,3,146,56,6,2,66,18826,134,13408
성북구,월곡1동,1108071,21785,12682,5954,6217,54,140,12,34,3,89,38,4,5,46,12596,86,9103
성북구,월곡2동,1108072,17119,9592,4077,5040,74,94,14,22,2,107,31,4,4,45,9514,78,7527
성북구,장위1동,1108076,19752,10202,4305,5504,41,128,11,12,2,65,22,6,3,34,10133,69,9550
성북구,장위2동,1108077,12001,6169,2335,3605,33,55,8,12,0,28,20,2,1,16,6115,54,5832
성북구,장위3동,1108078,12979,7476,2791,4439,35,55,9,17,2,41,16,2,4,20,7431,45,5503
성북구,석관동,1108085,29688,15449,6314,8455,80,182,20,33,4,137,40,7,6,70,15348,101,14239
강북구,삼양동,1109069,20114,9923,4596,4941,41,118,13,20,2,54,30,10,3,19,9847,76,10191
강북구,미아동,1109070,20749,11142,5154,5391,54,150,20,15,3,135,38,5,3,45,11013,129,9607
강북구,송중동,1109071,25018,12891,5689,6708,63,148,10,37,4,83,30,8,5,35,12820,71,12127
강북구,송천동,1109072,23856,12392,5542,6365,59,150,11,23,2,56,36,6,2,40,12292,100,11464
강북구,삼각산동,1109073,24397,14863,6871,7484,76,150,22,26,1,76,40,0,4,43,14793,70,9534
강북구,우이동,1109074,17898,9487,4008,5038,39,119,9,25,1,83,18,4,2,57,9403,84,8411
강북구,인수동,1109075,26279,13158,5880,6762,76,138,10,14,2,74,31,3,7,46,13043,115,13121
강북구,번1동,1109060,16772,8107,3517,4184,49,119,10,20,0,67,23,5,2,24,8020,87,8665
강북구,번2동,1109061,14315,7793,3501,3964,46,94,7,15,2,41,16,3,3,19,7711,82,6522
강북구,번3동,1109062,14592,8338,3647,4385,35,90,9,18,1,44,22,4,2,16,8273,65,6254
강북구,수유1동,1109063,18518,8938,4088,4434,47,119,13,25,7,65,32,4,4,41,8879,59,9580
강북구,수유2동,1109064,18694,10355,4301,5642,45,107,12,22,0,72,27,9,5,30,10272,83,8339
강북구,수유3동,1109065,21540,10678,4729,5375,62,165,10,18,0,104,30,3,5,47,10548,130,10862
도봉구,쌍문1동,1110051,18160,9407,4068,4895,63,117,11,12,0,96,22,2,5,34,9325,82,8753
도봉구,쌍문2동,1110052,16569,8943,3764,4782,64,124,6,16,3,70,23,4,1,23,8880,63,7626
도봉구,쌍문3동,1110053,14753,7684,3320,4028,41,108,7,12,0,57,25,4,3,22,7627,57,7069
도봉구,쌍문4동,1110054,15175,9045,3706,5027,41,99,6,15,0,48,15,1,8,31,8997,48,6130
도봉구,방학1동,1110055,23864,12665,5125,7103,44,123,8,25,4,80,30,5,4,28,12579,86,11199
도봉구,방학2동,1110056,17424,8691,3781,4583,31,95,10,12,1,53,30,1,3,23,8623,68,8733
도봉구,방학3동,1110057,22952,13895,5946,7529,37,112,9,30,2,86,26,2,0,41,13820,75,9057
도봉구,창1동,1110059,20272,11274,4709,6115,60,113,14,19,1,87,32,3,4,43,11200,74,8998
도봉구,창2동,1110060,24989,13008,5594,6896,67,154,11,25,0,82,39,3,6,32,12909,99,11981
도봉구,창3동,1110061,11984,5965,2626,3103,30,74,6,13,0,28,16,6,2,13,5917,48,6019
도봉구,창4동,1110062,22673,14428,5816,8072,76,127,14,33,2,112,39,0,2,51,14344,84,8245
도봉구,창5동,1110063,21200,12619,4877,7285,62,128,13,33,0,92,23,4,7,31,12555,64,8581
도봉구,도봉1동,1110064,19678,10837,4494,5911,46,138,9,25,2,56,32,5,8,30,10756,81,8841
도봉구,도봉2동,1110065,24133,14326,6057,7758,50,160,15,22,4,89,31,6,4,46,14242,84,9807
노원구,월계1동,1111051,19206,10863,4297,6152,48,121,8,23,1,64,37,3,3,24,10781,82,8343
노원구,월계2동,1111052,22341,12390,5153,6788,44,135,7,19,3,66,54,4,7,29,12309,81,9951
노원구,월계3동,1111053,24725,14588,5793,8230,48,161,15,33,1,86,74,4,10,38,14493,95,10137
노원구,공릉1동,1111079,32041,17516,7381,9302,82,210,22,49,3,174,70,11,7,68,17379,137,14525
노원구,공릉2동,1111056,31098,18307,7498,9976,107,199,17,42,1,187,71,4,4,76,18182,125,12791
노원구,하계1동,1111058,21901,12691,5069,7117,64,143,11,30,2,91,29,2,2,44,12604,87,9210
노원구,하계2동,1111059,18872,11956,5168,6392,64,106,5,21,1,86,19,1,4,33,11900,56,6916
노원구,중계본동,1111060,18201,10933,4691,5844,61,98,16,27,1,68,14,3,1,40,10864,69,7268
노원구,중계1동,1111061,20154,12618,5461,6727,68,107,12,28,1,73,24,6,4,43,12554,64,7536
노원구,중계2·3동,1111078,29915,17467,7687,9089,81,210,18,45,6,133,34,10,10,51,17374,93,12448
노원구,중계4동,1111064,16893,10019,4276,5405,49,92,4,28,3,51,21,4,3,33,9969,50,6874
노원구,상계1동,1111065,32224,17948,7488,9810,52,193,13,29,2,139,42,7,7,58,17840,108,14276
노원구,상계2동,1111066,17779,10209,4193,5604,65,112,15,16,1,78,16,3,3,29,10135,74,7570
노원구,상계3·4동,1111076,22515,12045,5062,6574,42,132,12,24,1,52,32,6,5,35,11977,68,10470
노원구,상계5동,1111069,21320,11807,4861,6500,45,151,9,15,0,71,29,4,5,40,11730,77,9513
노원구,상계6·7동,1111077,27731,16701,6689,9384,81,170,12,40,1,133,42,3,7,42,16604,97,11030
노원구,상계8동,1111072,17771,10799,4780,5635,43,106,11,30,0,64,21,1,2,38,10731,68,6972
노원구,상계9동,1111073,17287,10546,4236,5885,48,122,11,33,2,69,24,4,2,30,10466,80,6741
노원구,상계10동,1111074,15678,9740,3898,5460,50,112,10,21,0,80,20,1,3,28,9683,57,5938
은평구,녹번동,1112051,31450,16755,7203,8873,81,191,16,39,1,108,50,3,6,61,16632,123,14695
은평구,응암1동,1112059,25185,13736,6239,6886,92,172,17,42,4,101,30,3,6,72,13664,72,11449
은평구,응암2동,1112060,20925,11604,5165,6040,70,116,7,19,1,66,11,1,1,37,11534,70,9321
은평구,응암3동,1112073,22868,11780,5461,5786,79,144,14,25,1,76,40,4,5,41,11676,104,11088
은평구,증산동,1112067,13014,7689,3273,4115,45,89,6,21,2,40,14,3,1,25,7634,55,5325
은평구,수색동,1112068,9622,5898,2279,3402,29,65,14,10,1,36,11,2,4,20,5873,25,3724
은평구,신사1동,1112065,24162,13454,6253,6580,93,163,24,33,1,96,40,5,3,57,13348,106,10708
은평구,신사2동,1112066,16876,8575,3776,4433,52,106,23,18,0,55,17,4,0,36,8520,55,8301
은평구,갈현2동,1112056,24584,12537,5689,6197,100,180,16,34,4,112,41,5,4,65,12447,90,12047
은평구,구산동,1112057,26992,13946,6315,6940,112,183,18,30,2,104,44,7,6,81,13842,104,13046
은평구,갈현1동,1112055,20060,10308,4449,5369,63,162,11,30,5,71,33,4,6,42,10245,63,9752
은평구,진관동,1112071,44191,27093,11746,14324,170,238,37,50,1,192,48,3,5,113,26927,166,17098
은평구,불광1동,1112052,33711,19646,8203,10552,121,237,22,51,0,164,51,10,10,96,19517,129,14065
은평구,불광2동,1112072,24785,12698,5626,6491,60,199,15,28,2,95,24,7,1,67,12615,83,12087
은평구,대조동,1112058,24184,12124,5396,6115,91,164,18,38,2,103,39,1,2,70,12039,85,12060
은평구,역촌동,1112074,39599,20358,9608,9804,119,257,24,60,3,154,61,5,8,116,20219,139,19241
서대문구,충현동,1113073,16412,8835,3505,4923,57,103,10,27,2,64,39,3,6,42,8781,54,7577
서대문구,천연동,1113052,14535,9193,3772,5062,51,84,10,22,1,44,28,1,3,63,9141,52,5342
서대문구,북아현동,1113074,14251,8564,3392,4820,41,72,11,24,4,58,15,6,3,55,8501,63,5687
서대문구,신촌동,1113075,16964,7996,2696,4597,129,81,30,28,2,141,38,2,3,115,7862,134,8968
서대문구,연희동,1113076,30423,16091,6245,8906,165,158,43,30,2,149,46,4,7,190,15945,146,14332
서대문구,홍제1동,1113062,19421,11511,4796,6181,57,142,14,30,0,73,65,5,1,64,11428,83,7910
서대문구,홍제2동,1113065,12564,8202,3355,4486,43,95,9,21,1,46,37,2,2,48,8145,57,4362
서대문구,홍제3동,1113064,13198,7351,3324,3754,45,64,14,11,1,42,15,4,3,25,7302,49,5847
서대문구,홍은1동,1113066,19229,11520,5082,5966,59,118,24,20,1,68,34,3,4,57,11436,84,7709
서대문구,홍은2동,1113068,22779,11939,5226,6131,66,159,10,33,5,79,44,3,9,85,11850,89,10840
서대문구,남가좌1동,1113069,13544,9050,3653,5126,33,72,10,14,3,40,21,3,1,20,8996,54,4494
서대문구,남가좌2동,1113070,23540,13604,5703,7287,81,157,23,26,1,115,29,6,4,68,13500,104,9936
서대문구,북가좌1동,1113071,15692,10035,4070,5592,56,104,18,12,2,58,22,0,2,53,9989,46,5657
서대문구,북가좌2동,1113072,27222,14392,6554,7211,105,169,17,28,2,83,31,8,5,68,14281,111,12830
마포구,공덕동,1114077,30450,16438,6368,9350,75,166,24,33,2,172,35,7,5,71,16308,130,14012
마포구,아현동,1114078,20948,13219,4400,8358,52,95,20,29,0,98,22,3,2,63,13142,77,7729
마포구,도화동,1114075,18916,12386,4409,7520,62,115,19,23,1,81,21,2,2,48,12303,83,6530
마포구,용강동,1114059,17185,10875,3894,6596,41,101,11,34,2,69,25,2,3,46,10824,51,6310
마포구,대흥동,1114060,12304,6603,2350,3897,69,60,17,17,0,87,15,3,1,38,6554,49,5701
마포구,염리동,1114061,10328,6081,2408,3417,38,57,5,11,1,44,6,1,2,39,6029,52,4247
마포구,신수동,1114063,18438,10944,4141,6362,42,104,23,20,1,78,23,4,7,65,10870,74,7494
마포구,서강동,1114076,21095,12619,4680,7283,105,112,39,40,2,102,32,0,6,117,12518,101,8476
마포구,서교동,1114066,21825,11060,4595,5706,129,117,37,33,3,150,50,3,4,121,10948,112,10765
마포구,합정동,1114068,16472,9633,4059,4983,81,93,35,18,1,100,41,3,9,112,9535,98,6839
마포구,망원1동,1114069,18350,10397,4695,5042,110,130,31,27,0,104,42,5,1,124,10311,86,7953
마포구,망원2동,1114070,15961,9295,4303,4459,77,103,28,26,2,97,30,5,6,88,9224,71,6666
마포구,연남동,1114071,14521,7951,3461,4004,87,99,20,20,0,83,26,2,3,77,7882,69,6570
마포구,성산1동,1114072,16277,8616,4136,3957,102,98,21,10,3,85,33,3,5,111,8564,52,7661
마포구,성산2동,1114073,32388,18379,7922,9594,136,173,33,42,4,173,51,2,6,101,18237,142,14009
마포구,상암동,1114074,24234,15042,6243,8186,95,124,24,33,1,126,35,3,2,65,14937,105,9192
양천구,목1동,1115051,23253,14939,4813,9689,61,109,20,22,1,90,13,7,2,36,14863,76,8314
양천구,목2동,1115052,25505,14486,6109,7747,66,156,18,37,0,134,39,9,12,55,14382,104,11019
양천구,목3동,1115053,18871,10165,4086,5663,53,100,18,31,1,69,29,7,3,43,10103,62,8706
양천구,목4동,1115054,21552,12224,5078,6696,61,118,17,23,2,79,27,2,1,44,12148,76,9328
양천구,목5동,1115071,30396,20755,5942,14356,68,109,20,31,0,72,21,4,6,53,20682,73,9641
양천구,신월1동,1115057,18118,9107,4008,4781,39,92,7,18,0,55,19,2,4,23,9048,59,9011
양천구,신월2동,1115058,17300,9614,4034,5251,35,90,8,26,1,59,20,1,2,29,9556,58,7686
양천구,신월3동,1115059,12950,5965,2687,3070,32,65,4,9,0,21,14,3,2,13,5920,45,6985
양천구,신월4동,1115060,15196,8682,3982,4389,39,109,3,19,0,52,20,2,5,14,8634,48,6514
양천구,신월5동,1115061,12768,6809,3031,3531,34,66,9,16,1,40,18,4,5,18,6773,36,5959
양천구,신월6동,1115062,12218,8052,3377,4414,41,76,6,16,3,40,8,1,3,19,8004,48,4166
양천구,신월7동,1115063,17766,9881,4311,5243,39,109,4,23,2,34,18,2,8,22,9815,66,7885
양천구,신정1동,1115064,16227,10925,3822,6782,44,70,13,22,0,71,16,0,4,35,10879,46,5302
양천구,신정2동,1115065,16785,10962,4422,6210,49,64,10,20,2,65,23,0,5,30,10900,62,5823
양천구,신정3동,1115066,36724,20763,9074,11004,84,217,25,39,4,101,45,8,8,45,20654,109,15961
양천구,신정4동,1115072,28676,15131,6743,7732,67,181,21,34,0,119,44,7,9,54,15011,120,13545
양천구,신정6동,1115069,19275,13412,4101,8974,37,73,9,27,2,57,17,3,1,41,13342,70,5863
양천구,신정7동,1115070,23443,14610,5261,8860,60,146,20,27,3,81,22,10,6,31,14527,83,8833
강서구,염창동,1116051,32331,20079,8304,11018,96,182,22,47,0,145,56,4,7,83,19964,115,12252
강서구,등촌1동,1116052,21111,11403,4617,6193,77,135,17,33,2,108,48,2,7,58,11297,106,9708
강서구,등촌2동,1116053,17573,10034,3977,5669,31,93,14,29,1,68,33,6,6,34,9961,73,7539
강서구,등촌3동,1116054,27718,16711,6977,9122,65,174,17,37,0,100,41,7,8,44,16592,119,11007
강서구,화곡본동,1116055,28764,13269,6230,6362,95,179,22,34,2,117,63,3,7,51,13165,104,15495
강서구,화곡1동,1116073,44978,20201,9056,10146,132,263,34,67,0,204,62,8,3,69,20044,157,24777
강서구,화곡2동,1116057,15262,7358,3410,3636,51,83,5,24,0,49,13,7,1,21,7300,58,7904
강서구,화곡3동,1116058,19580,12062,4855,6729,57,121,16,26,0,96,38,3,3,45,11989,73,7518
강서구,화곡4동,1116059,18407,9126,4060,4721,36,109,16,20,1,49,28,4,3,29,9076,50,9281
강서구,화곡6동,1116061,22339,12317,4916,6852,73,137,17,28,1,101,36,5,2,49,12217,100,10022
강서구,화곡8동,1116063,22308,11514,5644,5335,54,146,9,30,1,88,51,4,2,48,11412,102,10794
강서구,우장산동,1116074,32703,19087,7262,11159,89,178,19,38,5,127,45,5,6,49,18982,105,13616
강서구,가양1동,1116064,28628,14463,5486,8323,73,132,22,38,0,172,43,4,5,53,14351,112,14165
강서구,가양2동,1116065,13750,8458,3327,4826,36,79,8,7,2,46,19,2,7,37,8396,62,5292
강서구,가양3동,1116066,14198,8639,3642,4654,31,103,11,12,2,53,28,4,0,30,8570,69,5559
강서구,발산1동,1116067,29378,17382,8020,8702,85,186,17,39,1,127,35,4,6,48,17270,112,11996
강서구,공항동,1116069,22919,11598,4880,6278,56,128,7,35,0,75,25,3,2,33,11522,76,11321
강서구,방화1동,1116070,35585,21092,8873,11511,87,221,17,43,0,114,46,5,7,53,20977,115,14493
강서구,방화2동,1116071,20080,10632,4174,6067,37,126,12,25,4,48,25,6,4,27,10555,77,9448
강서구,방화3동,1116072,20868,12759,5270,7072,48,118,11,24,1,55,29,2,3,39,12672,87,8109
구로구,신도림동,1117051,28743,18817,7302,10957,66,149,13,44,1,83,28,5,8,50,18706,111,9926
구로구,구로1동,1117052,17116,10789,4659,5746,46,107,7,18,3,65,33,2,3,33,10722,67,6327
구로구,구로2동,1117071,22789,10686,4884,5442,45,103,5,17,1,46,33,5,4,26,10611,75,12103
구로구,구로3동,1117054,21251,11150,5775,4912,52,126,7,23,1,68,44,5,5,44,11062,88,10101
구로구,구로4동,1117055,18737,9532,4446,4715,39,109,7,13,1,48,35,6,2,27,9448,84,9205
구로구,구로5동,1117056,26412,14746,6489,7715,62,128,12,29,0,112,48,3,2,50,14650,96,11666
구로구,가리봉동,1117070,9033,3695,1697,1859,8,48,6,3,3,11,13,2,2,12,3664,31,5338
구로구,고척1동,1117061,19782,11624,4761,6456,36,93,13,33,2,65,48,0,8,26,11541,83,8158
구로구,고척2동,1117062,22478,12423,5322,6653,64,123,14,20,3,63,52,7,3,27,12351,72,10055
구로구,개봉1동,1117072,29266,15920,6590,8783,63,166,11,33,1,66,44,7,5,35,15804,116,13346
구로구,개봉2동,1117064,27155,16534,7027,8940,58,189,13,27,2,98,37,2,3,42,16438,96,10621
구로구,개봉3동,1117065,17921,9697,4317,5082,31,77,9,17,0,43,17,5,5,26,9629,68,8224
구로구,오류1동,1117067,20840,11253,4620,6134,48,128,7,31,1,95,38,7,2,44,11155,98,9587
구로구,오류2동,1117073,30996,17928,7842,9441,75,175,8,49,0,93,66,12,10,60,17831,97,13068
구로구,수궁동,1117069,20254,11732,4466,6864,44,129,9,20,2,59,22,7,3,38,11663,69,8522
구로구,항동,1117074,12335,7737,3759,3663,40,90,4,17,1,35,44,4,0,31,7688,49,4598
금천구,가산동,1118051,21937,9649,4431,4611,58,137,22,39,1,139,43,5,2,46,9534,115,12288
금천구,독산1동,1118052,36068,18705,8139,9780,77,214,23,52,3,157,53,9,9,59,18575,130,17363
금천구,독산2동,1118053,16967,7988,3692,4001,39,99,2,13,4,36,17,2,2,21,7928,60,8979
금천구,독산3동,1118054,22597,10635,4912,5261,49,128,11,27,0,82,39,5,6,32,10552,83,11962
금천구,독산4동,1118055,14315,7022,3305,3478,23,69,4,13,5,43,19,2,2,14,6977,45,7293
금천구,시흥1동,1118057,29406,14921,6205,8134,57,163,16,42,2,86,41,6,3,46,14801,120,14485
금천구,시흥2동,1118058,17847,10967,4792,5867,43,85,16,19,0,59,12,1,0,22,10916,51,6880
금천구,시흥3동,1118059,9907,5741,2496,3021,36,68,6,15,1,26,13,4,0,18,5704,37,4166
금천구,시흥4동,1118060,17735,8963,3965,4690,40,93,14,16,1,44,27,6,6,21,8923,40,8772
금천구,시흥5동,1118061,17370,9093,4002,4743,33,108,7,18,4,49,27,3,1,31,9026,67,8277
영등포구,영등포본동,1119073,18987,10882,4396,6093,42,121,14,22,1,47,17,3,4,37,10797,85,8105
영등포구,영등포동,1119074,24343,11264,4150,6520,79,143,17,35,1,124,30,4,0,58,11161,103,13079
영등포구,여의동,1119054,27396,18047,3844,13816,50,72,21,27,0,79,18,2,5,51,17985,62,9349
영등포구,당산1동,1119055,19425,11605,4557,6509,78,127,16,23,2,104,27,2,6,51,11502,103,7820
영등포구,당산2동,1119056,30924,18477,6407,11290,124,175,29,36,1,157,40,4,2,88,18353,124,12447
영등포구,도림동,1119075,16555,8797,3834,4623,41,98,6,23,1,47,27,1,2,30,8733,64,7758
영등포구,문래동,1119076,26501,16691,6725,9375,73,151,14,44,3,100,24,5,8,65,16587,104,9810
영등포구,양평1동,1119061,15050,8459,3613,4467,53,96,13,25,1,68,40,4,0,27,8407,52,6591
영등포구,양평2동,1119062,18402,10773,4442,5877,72,94,14,33,0,87,29,5,4,41,10698,75,7629
영등포구,신길1동,1119063,15653,7787,3185,4197,39,103,11,20,1,68,31,4,5,37,7701,86,7866
영등포구,신길3동,1119065,13982,7688,3055,4374,36,79,11,10,1,30,18,3,2,16,7635,53,6294
영등포구,신길4동,1119066,10614,6192,2460,3480,30,58,10,9,2,41,13,4,1,19,6127,65,4422
영등포구,신길5동,1119067,9912,5625,2258,3177,23,50,4,7,0,38,16,5,0,6,5584,41,4287
영등포구,신길6동,1119068,17208,9995,3936,5647,50,104,12,30,1,58,32,4,3,30,9907,88,7213
영등포구,신길7동,1119069,15203,9322,3067,5936,37,79,10,17,1,63,9,2,5,30,9256,66,5881
영등포구,대림1동,1119070,13489,7140,3019,3860,34,75,10,11,0,35,27,5,4,19,7099,41,6349
영등포구,대림2동,1119071,12694,5719,2479,2993,23,70,11,8,3,43,24,2,1,18,5675,44,6975
영등포구,대림3동,1119072,20159,10697,4570,5713,61,119,7,20,1,61,29,5,3,32,10621,76,9462
동작구,노량진1동,1120072,26442,15063,5628,8848,63,170,15,29,2,104,37,4,5,48,14953,110,11379
동작구,노량진2동,1120052,13078,7339,3005,3970,39,96,8,17,1,68,31,3,4,27,7269,70,5739
동작구,상도1동,1120053,37201,21519,7864,12769,101,186,34,62,3,170,59,2,10,81,21341,178,15682
동작구,상도2동,1120054,23238,13423,4976,7992,58,110,6,38,0,90,21,3,6,43,13343,80,9815
동작구,상도3동,1120055,23452,13506,6338,6521,75,181,20,40,4,129,35,4,4,56,13407,99,9946
동작구,상도4동,1120056,23758,11875,5295,6029,67,149,14,29,3,92,37,6,6,46,11773,102,11883
동작구,흑석동,1120071,26642,16092,5128,10454,67,107,24,25,0,99,33,5,8,52,16002,90,10550
동작구,사당1동,1120063,20455,10900,4759,5563,72,150,21,29,2,85,49,4,4,57,10795,105,9555
동작구,사당2동,1120073,23434,14554,5255,8812,55,145,12,22,0,83,11,3,2,55,14455,99,8880
동작구,사당3동,1120065,19920,12102,4459,7264,55,84,14,25,1,67,24,2,3,36,12034,68,7818
동작구,사당4동,1120066,12731,7409,3369,3722,32,90,10,18,3,67,16,2,4,21,7354,55,5322
동작구,사당5동,1120067,12334,7287,3125,3889,32,75,9,27,0,57,13,0,0,23,7250,37,5047
동작구,대방동,1120068,30326,17005,6880,9414,99,149,17,39,2,148,53,6,6,75,16888,117,13321
동작구,신대방1동,1120069,19427,11210,4407,6403,38,94,10,24,0,77,38,6,0,27,11124,86,8217
동작구,신대방2동,1120070,16813,9690,4055,5214,69,103,15,26,1,87,22,3,3,36,9634,56,7123
관악구,보라매동,1121052,21307,11056,4973,5538,51,146,21,24,2,101,67,8,5,35,10971,85,10251
관악구,은천동,1121078,28398,15753,7265,7796,80,183,21,33,2,111,72,8,3,65,15639,114,12645
관악구,성현동,1121079,24385,14669,6607,7534,50,138,16,34,2,89,55,3,5,43,14576,93,9716
관악구,중앙동,1121061,14104,6984,3167,3325,68,93,15,27,0,123,40,10,4,46,6918,66,7120
관악구,청림동,1121054,12887,8224,3528,4407,38,61,15,17,0,41,24,2,2,26,8161,63,4663
관악구,행운동,1121057,26108,14041,6157,7001,104,182,40,63,2,181,73,5,7,82,13897,144,12067
관악구,청룡동,1121080,31828,16428,6988,8265,129,205,44,60,1,239,98,11,10,137,16187,241,15400
관악구,낙성대동,1121058,15014,7705,3196,3965,72,88,34,25,1,108,38,6,3,73,7609,96,7309
관악구,인헌동,1121062,23421,12861,5733,6356,97,150,24,48,1,150,64,4,9,80,12716,145,10560
관악구,남현동,1121063,15943,8888,3641,4836,45,88,16,25,1,88,25,5,3,40,8813,75,7055
관악구,신림동,1121069,21020,8507,3639,4171,89,174,36,34,0,129,63,4,6,47,8392,115,12513
관악구,신사동,1121068,20928,9495,4128,4748,62,155,17,43,1,147,49,9,5,32,9396,99,11433
관악구,조원동,1121072,16126,7869,3331,4096,44,120,14,29,0,68,23,3,3,38,7769,100,8257
관악구,미성동,1121083,26733,14424,6078,7777,64,165,13,37,0,104,41,4,9,35,14327,97,12309
관악구,난곡동,1121081,23624,11804,5388,5905,61,158,18,35,0,66,31,7,0,39,11708,96,11820
관악구,난향동,1121071,12969,7593,3545,3796,34,91,6,13,1,31,20,1,3,17,7558,35,5376
관악구,서원동,1121064,20730,9533,4189,4708,94,131,22,40,2,119,39,3,3,58,9408,125,11197
관악구,신원동,1121065,16792,8263,3688,4066,63,142,27,28,0,89,43,2,5,32,8185,78,8529
관악구,서림동,1121066,20013,9704,4065,5043,75,155,33,32,1,90,41,5,4,61,9605,99,10309
관악구,삼성동,1121082,20800,12279,5605,6194,58,128,17,39,0,69,37,4,6,41,12198,81,8521
관악구,대학동,1121073,21659,11000,4692,5663,74,150,36,43,2,100,57,4,3,71,10895,105,10659
서초구,서초1동,1122051,17632,10781,2878,7598,34,80,16,15,1,47,25,3,5,28,10730,51,6851
서초구,서초2동,1122052,17985,10996,2577,8129,31,72,9,17,0,69,13,4,2,36,10959,37,6989
서초구,서초3동,1122053,27354,16470,4238,11763,61,109,19,30,0,93,14,3,6,50,16386,84,10884
서초구,서초4동,1122054,23228,15369,2665,12377,52,54,20,26,0,54,14,3,2,44,15311,58,7859
서초구,잠원동,1122055,21955,13944,2778,10862,50,71,15,17,2,57,10,3,1,33,13899,45,8011
서초구,반포본동,1122056,9267,6585,1450,5007,24,34,4,2,0,21,2,0,1,13,6558,27,2682
서초구,반포1동,1122057,25678,14804,3432,11018,45,80,8,17,0,60,20,0,1,48,14729,75,10874
서초구,반포2동,1122058,11467,8232,1207,6910,16,27,4,10,0,18,6,0,0,14,8212,20,3235
서초구,반포3동,1122059,17412,11842,2057,9600,32,35,3,11,0,44,11,2,0,13,11808,34,5570
서초구,반포4동,1122060,14882,9483,2144,7131,21,57,3,13,0,31,11,3,2,27,9443,40,5399
서초구,방배본동,1122061,16570,10589,2741,7596,40,56,3,14,2,43,9,2,3,31,10540,49,5981
서초구,방배1동,1122062,14491,9016,2743,5981,27,72,18,21,3,49,14,1,3,33,8965,51,5475
서초구,방배2동,1122063,16859,10661,3537,6749,45,101,5,23,2,78,18,6,1,46,10611,50,6198
서초구,방배3동,1122064,16640,10624,2668,7676,42,66,8,15,0,54,14,2,2,29,10576,48,6016
서초구,방배4동,1122065,18933,11599,3541,7711,52,89,15,17,1,69,13,1,2,32,11543,56,7334
서초구,양재1동,1122066,34146,20453,7125,12720,74,186,22,41,0,91,25,4,1,54,20343,110,13693
서초구,양재2동,1122067,19190,10660,4262,5988,54,117,13,19,0,73,22,6,1,36,10591,69,8530
서초구,내곡동,1122068,14452,9095,3023,5827,35,60,12,15,1,35,11,1,2,27,9049,46,5357
강남구,신사동,1123051,13922,8672,1581,6910,20,45,6,15,1,36,5,3,1,20,8643,29,5250
강남구,논현1동,1123052,20720,8611,2765,5543,34,75,14,22,2,55,12,3,1,26,8552,59,12109
강남구,논현2동,1123053,18750,9381,2334,6801,30,69,11,11,0,51,6,4,3,14,9334,47,9369
강남구,압구정동,1123077,21582,14357,1502,12648,31,52,6,13,0,41,4,4,0,22,14323,34,7225
강남구,청담동,1123078,22018,12578,2264,10066,36,64,8,20,0,37,9,2,6,27,12539,39,9440
강남구,삼성1동,1123058,11250,6927,1408,5350,23,63,9,7,0,23,7,1,0,11,6902,25,4323
강남구,삼성2동,1123059,24352,14345,3443,10533,47,118,9,16,1,63,19,2,2,35,14288,57,10007
강남구,대치1동,1123060,18109,13123,1781,11130,27,55,5,13,0,31,3,1,3,27,13076,47,4986
강남구,대치2동,1123079,27620,18495,3129,14974,51,98,12,26,2,57,11,2,3,54,18419,76,9125
강남구,대치4동,1123063,17559,9103,2807,5977,30,82,6,25,1,62,14,2,0,34,9040,63,8456
강남구,역삼1동,1123064,32110,13241,4149,8521,57,167,16,38,1,111,19,7,3,51,13140,101,18869
강남구,역삼2동,1123065,28878,17104,4092,12588,70,101,14,21,0,85,13,3,4,43,17034,70,11774
강남구,도곡1동,1123066,17453,11351,2665,8406,43,63,7,19,1,55,18,1,3,19,11300,51,6102
강남구,도곡2동,1123067,25337,17115,2335,14467,47,72,15,12,1,66,10,2,1,40,17068,47,8222
강남구,개포1동,1123068,5813,4045,793,3181,6,26,1,5,2,11,0,1,0,6,4032,13,1768
강남구,개포2동,1123080,17767,12364,2463,9653,32,69,6,14,0,44,14,2,2,19,12318,46,5403
강남구,개포4동,1123071,19230,11540,3410,7800,45,94,7,9,1,56,6,4,0,30,11462,78,7690
강남구,일원본동,1123072,18027,11816,3209,8308,47,80,13,19,1,44,12,5,0,33,11771,45,6211
강남구,일원1동,1123073,13545,8059,2767,4997,32,94,6,10,1,47,15,5,3,22,7999,60,5486
강남구,일원2동,1123074,14598,9566,2752,6564,26,89,6,9,0,30,15,4,3,23,9521,45,5032
강남구,수서동,1123075,13916,8896,2920,5714,25,72,8,15,1,33,5,5,3,19,8820,76,5020
강남구,세곡동,1123076,33769,19961,7349,12021,88,160,15,43,1,105,28,5,2,33,19850,111,13808
송파구,풍납1동,1124051,12077,6767,2643,3874,24,79,5,11,3,51,13,0,2,22,6727,40,5310
송파구,풍납2동,1124052,20892,12119,4299,7411,46,122,19,22,1,72,21,1,3,33,12050,69,8773
송파구,거여1동,1124053,11133,6453,2494,3710,27,88,4,10,1,44,15,3,3,14,6413,40,4680
송파구,거여2동,1124054,16378,9904,3870,5641,36,115,12,15,3,58,21,2,4,36,9813,91,6474
송파구,마천1동,1124055,15145,7448,3003,4157,42,97,9,15,0,37,17,4,4,20,7405,43,7697
송파구,마천2동,1124056,18591,10612,4576,5666,29,136,5,21,2,44,27,6,5,26,10543,69,7979
송파구,방이1동,1124057,13850,8686,3111,5267,50,75,8,12,0,60,12,3,3,29,8630,56,5164
송파구,방이2동,1124058,22826,11248,4367,6306,52,183,21,26,0,129,28,4,0,36,11152,96,11578
송파구,오륜동,1124059,14522,10507,2213,8095,20,54,12,15,0,32,9,2,0,17,10469,38,4015
송파구,오금동,1124060,32495,19256,6641,11920,95,189,27,47,2,108,25,10,5,64,19133,123,13239
송파구,송파1동,1124061,21905,12165,4706,6907,86,129,18,30,0,110,37,3,3,43,12072,93,9740
송파구,송파2동,1124062,16530,10746,3350,7072,43,87,10,20,3,54,20,2,2,28,10691,55,5784
송파구,석촌동,1124063,28154,14517,6011,7869,88,172,20,41,0,118,36,8,7,42,14412,105,13637
송파구,삼전동,1124064,27388,13986,5952,7450,74,164,22,23,2,112,24,4,2,42,13871,115,13402
송파구,가락본동,1124065,22537,12762,4332,7964,42,166,12,16,2,84,12,7,3,34,12674,88,9775
송파구,가락1동,1124066,21590,14418,3553,10530,42,84,10,33,2,54,10,1,3,30,14352,66,7172
송파구,가락2동,1124067,26117,16059,5400,10139,56,151,14,31,2,101,29,6,2,42,15973,86,10058
송파구,문정1동,1124068,18236,11060,3752,6934,51,114,8,27,0,68,14,3,5,23,10999,61,7176
송파구,문정2동,1124069,24903,14708,3677,10609,49,91,24,26,0,97,18,3,0,49,14643,65,10195
송파구,장지동,1124081,25155,15110,6112,8452,53,171,12,31,0,97,32,4,6,39,15009,101,10045
송파구,잠실본동,1124071,24836,12609,4843,7215,72,131,23,29,0,114,20,4,3,53,12507,102,12227
송파구,잠실2동,1124079,26658,18025,4364,13252,72,92,13,26,3,60,13,4,2,43,17944,81,8633
송파구,잠실3동,1124080,26416,18247,3672,14185,54,100,13,24,0,62,13,2,1,36,18162,85,8169
송파구,잠실4동,1124075,16243,11087,2675,8191,26,57,4,15,0,46,11,2,0,15,11042,45,5156
송파구,잠실6동,1124077,14057,9691,2162,7298,39,52,15,10,2,35,8,6,2,28,9657,34,4366
송파구,잠실7동,1124078,8442,6269,1092,5040,15,24,8,9,0,29,6,1,2,16,6242,27,2173
송파구,위례동,1124082,22108,13335,4963,7983,41,118,7,25,1,64,27,4,4,33,13270,65,8773
강동구,강일동,1125051,30616,18253,8261,9362,81,208,10,40,2,100,38,8,4,41,18155,98,12363
강동구,상일동,1125052,28281,18559,6219,11802,66,171,15,32,1,81,27,3,3,40,18460,99,9722
강동구,명일1동,1125053,21870,13810,4516,8842,48,139,14,20,1,78,15,9,2,41,13725,85,8060
강동구,명일2동,1125054,14110,9570,2966,6272,42,72,9,23,0,69,17,3,2,36,9511,59,4540
강동구,고덕1동,1125055,18788,12095,4204,7551,46,101,5,41,1,52,10,2,4,27,12044,51,6693
강동구,고덕2동,1125056,17458,10948,3303,7349,21,104,10,28,1,39,17,3,1,25,10901,47,6510
강동구,암사1동,1125072,28898,14888,5933,8405,85,177,9,27,0,80,34,7,7,31,14795,93,14010
강동구,암사2동,1125058,13683,8848,3396,5150,29,79,9,22,1,65,18,3,3,28,8803,45,4835
강동구,암사3동,1125059,14815,9805,3311,6226,48,67,6,18,1,51,11,2,3,24,9768,37,5010
강동구,천호1동,1125061,23884,12749,5086,7188,61,153,9,18,2,65,25,7,6,33,12653,96,11135
강동구,천호2동,1125073,29875,15193,6123,8495,55,210,15,17,3,77,33,9,5,43,15085,108,14682
강동구,천호3동,1125063,23498,12218,4699,7020,64,155,11,28,2,89,27,2,5,33,12135,83,11280
강동구,성내1동,1125065,16899,10195,4057,5764,43,115,9,16,0,65,22,4,0,22,10117,78,6704
강동구,성내2동,1125066,21172,10914,4324,6152,48,137,16,29,1,74,23,4,4,26,10838,76,10258
강동구,성내3동,1125067,20551,11728,4662,6608,48,140,18,31,2,74,31,5,7,37,11663,65,8823
강동구,길동,1125074,39506,20557,7786,12053,71,236,18,40,5,139,44,9,4,41,20446,111,18949
강동구,둔촌2동,1125071,21178,12330,4493,7434,54,119,11,23,2,68,21,5,5,32,12267,63,8848
